10 10 1.5 1.5 0
##########
#_#______#
#_#_###_##
#___#_#_#
#_#_#_#__#
###_#____#
#_#__#_#_#
#_#__#_#_#
#____#_#_#
##########